#############
#           #
#           #
#           #
#           #
#           #
#     B     #
#     S     #